...............................
...............................
...............................
............#........#.........
............#........#.........
............#........#.........
...............................
.......#..................#....
........#................#.....
.........################......
...............................
...............................
...............................

░▒▓█