................................................
..........#.......................#.............
................................................
..........#########################.............
..........#.......................#.............
..........#.......................#.............
..........#.......................#.............
..........#.......................#.............
..........#...........P...........#.............
..........#.......................#.............
................................................
................................................
